+--+--+--+--+--+--+--+--+--+--+
g              |           |  |
+  +--+  +--+  +  +--+  +  +  +
|  |     |     |  |     |     |
+  +--+--+  +--+  +  +--+--+--+
|        |        |     |     |
+--+--+  +--+--+--+--+  +--+  +
|        |           |        |
+  +--+--+  +--+--+  +--+--+  +
|     |     |  |     |     |  |
+--+  +--+--+  +  +--+  +--+  +
|  |     |     |     |        |
+  +--+  +  +  +--+  +--+--+--+
|  |        |  |        |     |
+  +  +--+--+--+  +--+  +  +--+
|                 |     |     |
+--+  +--+--+--+--+--+--+  +  +
|     |     |           |  |  |
+  +--+  +  +  +--+--+  +  +  +
|        |           |     |  o
+--+--+--+--+--+--+--+--+--+--+